1111111111111
1P01000000001
1000011111001
100011E0000C1
1111111111111
