1111111111111111111111111111111111
1E0000000000000000C0000000C00000C1
10100101001000001010010000C0010101
1010010010101010001001000C00010101
1P000000000C0000000C000000000000C1
1111111111111111111111111111111111
