111111111
100C010E1
1P0a001C1
100C00001
111111111
