1111111111111111111111111111111111
1E0000000000000C00000C000000000001
1010010100100000101001000000010101
1010010010101010001001000000010101
1P0000000C00C0000000000000000000C1
1000001010001000000100001010101001
11110000000000000000C000010C000001
10000000010111110000000C0010000001
10000001100000CCC00001110101000001
1000S0000S00000100000CC00001010001
1000SSS000CCCC0010110CCC0111101001
1000000CSS00000010001000S000S000S1
1111111111111111111111111111111111
